Testing
, Grass ^ Forest = Road # Forest ~ Road
,,,,,,,,,,,,,,,,,,,,,,,,,,,,,
,,,,,,,,,,,,,,,,,,,,,,,,,,,,,
,,,,,,,,,,,,,,,,,,,,,,,,,,,,,
=============,,,,,,,,,,,,,###
,,,,,,,,,,,,=,,,,,,,,,#######
,,,,,,,,,,,,=,,,,############
,,,,,,,,,,,,=,###############
,,,,,,,,,,,,=################
,,,,,,,,,,,,=################
,,,,,,,,,,,,=,###############
,,,,,,,,,,,,=,,##############
,,,,,,,,,,,,=,,#,,,,#########
,,,,,,,,,,,,=,,,,,,,,,,,,,###
,,,,,,,,,,,,=,,,,,,,,,,,,,,,,
,,,,,,,,,,,,=,,,,,,,,,,,,,,,,
,,,#,,,,,#,,=,,#,,,,,#,,,,,#,
=============================
,,,#,,,,,#,,,,,#,,,,,#,,,,,#,
,,,,,,,,,,,,,,,,,,,,,,,,,,,,,
,,,,,,,,,,,,,,,,,,,,,,,,,,,,,
^,,,,,,,,,,,,,,,,,,,,,,,,,~~~
^,~~~~~~~~~~~~~~~,,,,,,,,~~,,
^,,,,,,,,,,,,,,,~~,,,,,,~~,,,
^,,,,,,,,,,,,,,,,~~~~~~~~,,,,
^^,,,,,,,,,,,,,,,,,,,,,,,,,,,
^^^,,,,,,,,,,,,,,,,,,,,,,,,,,
^^^^^,,,,,,,,,,,,,,,,,,,,,,,,
^^^^^^^^^^^^,,,,,,,,,,,,,,,,,
^^^^^^^^^^^^^^^^^^^,,,,,,,,,,
^^^^^^^^^^^^^^^^^^^^^^^^^^^^^